3300220044
3002112004
0002222000
0211111120
0205112610
0132114020
0211111120
0002222000
5002112006
5500220066
