3000220004
3002112004
0002222000
0211111120
0200110610
0130110020
0211111120
0002222000
5002112006
5000220006
