3000000004
0002222000
0100000000
0211111120
0210110120
0210110120
0211111120
0000000000
0002222000
5000000006
